#: grass, G: green gem
##WWWWWWWWWWWDD
##WSSSSSSSSKWDD
###SSSSSSSSS#DD
###SSSSBSSSS##D
##WSBSSSSSSSW#D
#BWSSSSSBSSSWDD
##WSSSPSSBSSWBD
###SSSSSSSSS#DD
###SSBSSSSSS#DD
#PWWWWWWWWWWWSS
###############
