#: grass, G: gem, W: water, D: dirt, P: player, K: key, S: stone
##WWWWWWWWWWWDD
##WSSSSSSSSKWDD
##WSSSSSSSSSWDD
##WSBSSBSBSSW#D
##WSBSSBSSSSW#D
##WSSSSSSSSSWDD
##WSSSBSSBSSWDD
##WSSSSSSSSSWDD
##WPSSSSSBSSWDD
##WWWWWWWWWWWSS
###############
